text	label
Divna Ivana Brlić - Mažuranić i njena nevjerojatna mašta... 	pozitivno
Ovakvo književno bogatstvo treba čuvati. 	pozitivno
Preporučam svima koji su njene priče voljeli kao malci, pročitajte njenu kratku biografiju u knjizi "Proklete Hrvatice" Milane Vuković - Runjić. 	neutralno
Ili "U potrazi za Ivanom", autorice kojoj se nažalost ne mogu sjetiti imena. 	neutralno
Zbilja jedna divna i posebna žena, vječno dijete zarobljeno u konvencijama vremena i društva... kao i svi mi. 	pozitivno
Imam osjećaj da mi je ova bajka svaki put kad je iznova pročitam sve bolja. 	pozitivno
Pripremala sam pitanja za svoje četvrtaše i o toliko se toga može razgovarati. 	pozitivno
Najviše me se dojmilo to koliko je kroz ovu bajku Ivana dočarala bezuvjetnu majčinsku ljubav. 	pozitivno
Sjećam se da kao mala, nikada nisam do kraja shvatila bit ove priče. 	neutralno
Moram je ponovno pročitati. 	pozitivno
Lijepo je sjetiti se djetinjstva uz ovo legendarno djelo... 	pozitivno
Od svih pročitanih djela, ovo je jedino koje sam imao priliku upoznati kroz niz različitih adaptacija. 	neutralno
Prvo sam pogledao animirani film, pa ju preslušao na audio kaseti i, napokon, pročitao u izvornom obliku (igrani film još nisam pogledao, nap.). 	neutralno
Da ne zaboravim i činjenicu kako je animirani lik Hlapića maskota za promociju zaštite u prometu. 	neutralno
Ako uzmem u obzir i kako je ovo prvi roman za djecu proizašao iz hrvatske književnosti, onda je i više nego dovoljno argumenata da se nađe na listi najboljih hrvatskih romana ikada napisanih. 	pozitivno
Vjerujem kako i danas ima svoje draži kroz zgode na putovanju i ishode na kraju svake epizode u poglavljima ili poruke koje šalje čitateljima (dobrota, pomaganje, odrastanje i promjene na bolje). 	pozitivno
Svakako vrijedi spomenuti i atmosferu koja prevladava u knjizi, a koja se izmjenjuje danju (kada je sve veselo, živahno i radno) i noću (tajanstveno i zastrašujuće), kao i tonovi u bojama odjeće glavnog protagonista (crvena i zelena) i antagonista (crna). 	neutralno
Ukratko, jedno od najljepših djela hrvatske književnosti koje svatko treba pročitati, ili poslušati, ili pogledati. 	pozitivno
Izbor je raznolik i nema krivog odabira, jer svaka verzija nudi svoje specifičnosti i divne doživljaje, kako za djecu, tako i za odrasle kojima može pobuditi stare uspomene. 	pozitivno
Istinski klasik hrvatske dječje književnosti, Čudnovate zgode šegrta Hlapića je roman kakav se poželjeti može. 	pozitivno
Jezik kojim je pisan tako je milozvučan, a u isto vrijeme blizak i drag. 	pozitivno
Roman je to koji nosi u sebi nešto osjećaja i tradicije starih bajki, a u isto vrijeme je dosta realan i poučan i za svakodnevni život. 	pozitivno
Ovaj roman ne nudi životne lekcije samo u prenesom smislu, već i na moderniji način pa tako upozorava djecu na stvarne opasnosti u kojem se mogu sresti u svakodnevnom životu. 	pozitivno
Upozorava na zlo u ljudima, ali potiče vjeru u dobro i u to da se dobro dobrim vraća. 	pozitivno
Stil pisanja ima u sebi svježinu, a opet zadržao je tradicijske vrijednosti i jezično bogatsvo bajkovitih priča. 	pozitivno
Šegrt Hlapić divan je protagonist, dječak kojeg je nemoguće ne voljeti. 	pozitivno
Međutim, zapravo je njegova hrabra prijateljica Gita taj lik kojeg najbolje patim iz djetinstva i koji me se najviše dojmio. 	pozitivno
Nedavno sam imala priliku ponovo pročitati dio ovog romana i bilo je to lijepo iskustvo.  	pozitivno
Čudnovate zgode šegrta Hlapića je roman koji me ponovo oduševio. 	pozitivno
Pročitao za sat vremena. 	neutralno
Čudi me ako je ovo prvi stripovski uradak Čudnovatih zgoda Šegrta Hlapića. 	neutralno
Ne sjećam se da sam ikada vidio nekakav strip - ako je i bio, ja se ne sjećam. 	neutralno
I meni je drago što Hlapić više nije miš(koji je to klinac bio!?) već dječak, iz starog Broda na Savi koji je mukotrpno radio kod strogog majstora pokraj Ivanine kuće. 	pozitivno
Nisam stručnjak za crtež ili stripovsku formu, ali po meni je ovo odlično i sve u superlativima. 	pozitivno
Drži se knjige kao pijan plota i prati Ivanine riječi. 	neutralno
Izvrsna je to prilika da se najmlađe uvede u Svijet Bajki i da pristupe čitanju kao nečemu zabavnom. 	pozitivno
Jer, kako i sam Hlapić kaže Giti na kraju romana: "Zato je najbolje, da se sad naigramo a poslije ćemo narasti kao i drugi ljudi." 	neutralno
Prekrasna priča koja svakim novim čitanjem iznova svjedoči o genijalnosti svoje autorice. 	pozitivno
Klasik hrvatske književnosti. 	pozitivno
Baka je najbolji lik u priči - od nje se sve može naučiti. 	pozitivno
A sin... pa, čovjek, zar ne? 	neutralno
Divna Ivana Brlić - Mažuranić i njena nevjerojatna mašta... Ovakvo književno bogatstvo treba čuvati. 	pozitivno
Preporučam svima koji su njene priče voljeli kao malci, pročitajte njenu kratku biografiju u knjizi "Proklete Hrvatice" Milane Vuković - Runjić. 	pozitivno
Ili "U potrazi za Ivanom", autorice kojoj se nažalost ne mogu sjetiti imena. 	neutralno
Zbilja jedna divna i posebna žena, vječno dijete zarobljeno u konvencijama vremena i društva... kao i svi mi. 	pozitivno
Imam osjećaj da mi je ova bajka svaki put kad je iznova pročitam sve bolja. 	pozitivno 
Pripremala sam pitanja za svoje četvrtaše i o toliko se toga može razgovarati. 	neutralno
Najviše me se dojmilo to koliko je kroz ovu bajku Ivana dočarala bezuvjetnu majčinsku ljubav. 	pozitivno
Sjećam se da kao mala, nikada nisam do kraja shvatila bit ove priče. 	neutralno
Moram je ponovno pročitati. 	neutralno
Pročitao sam to mnogo puta. 	neutralno
Dobro je odležao. 	neutralno
Avanture starice i njenog sina. 	neutralno
Lijepo je sjetiti se djetinjstva uz ovo legendarno djelo. 	pozitivno 
Nakon dugo godina vratila sam se šegrtu Hlapiću i iznenadila se kako je dobar dio priče do dan danas čvrsto ostao u mom sjećanju (ne događa se to baš s velikim brojem knjiga, čak niti onima koje mi se jako svide). 	neutralno
Koliko je samo mašte, divnih misli i optimizma Ivana Brlić-Mažuranić sabrala u ovom divnom dječjem romanu. 	pozitivno
Radujem se iznova mu se vraćati, sada kad i vlastitu djecu upoznajem s hrabrim Hlapićem. 	pozitivno
Od svih pročitanih djela, ovo je jedino koje sam imao priliku upoznati kroz niz različitih adaptacija. 	neutralno
Prvo sam pogledao animirani film, pa ju preslušao na audio kaseti i, napokon, pročitao u izvornom obliku (igrani film još nisam pogledao, nap.). 	neutralno
Da ne zaboravim i činjenicu kako je animirani lik Hlapića maskota za promociju zaštite u prometu. 	neutralno 
Ako uzmem u obzir i kako je ovo prvi roman za djecu proizašao iz hrvatske književnosti, onda je i više nego dovoljno argumenata da se nađe na listi najboljih hrvatskih romana ikada napisanih. 	pozitivno 
Vjerujem kako i danas ima svoje draži kroz zgode na putovanju i ishode na kraju svake epizode u poglavljima ili poruke koje šalje čitateljima (dobrota, pomaganje, odrastanje i promjene na bolje). 	pozitivno
Svakako vrijedi spomenuti i atmosferu koja prevladava u knjizi, a koja se izmjenjuje danju (kada je sve veselo, živahno i radno) i noću (tajanstveno i zastrašujuće), kao i tonovi u bojama odjeće glavnog protagonista (crvena i zelena) i antagonista (crna). 	neutralno
Ukratko, jedno od najljepših djela hrvatske književnosti koje svatko treba pročitati, ili poslušati, ili pogledati. 	pozitivno
Izbor je raznolik i nema krivog odabira, jer svaka verzija nudi svoje specifičnosti i divne doživljaje, kako za djecu, tako i za odrasle kojima može pobuditi stare uspomene. 	pozitivno 
Istinski klasik hrvatske dječje književnosti, Čudnovate zgode šegrta Hlapića je roman kakav se poželjeti može. 	pozitivno 
Jezik kojim je pisan tako je milozvučan, a u isto vrijeme blizak i drag. 	pozitivno
Roman je to koji nosi u sebi nešto osjećaja i tradicije starih bajki, a u isto vrijeme je dosta realan i poučan i za svakodnevni život. 	neutralno 
Ovaj roman ne nudi životne lekcije samo u prenesenom smislu, već i na moderniji način pa tako upozorava djecu na stvarne opasnosti u kojem se mogu sresti u svakodnevnom životu. 	neutralno
Upozorava na zlo u ljudima, ali potiče vjeru u dobro i u to da se dobro dobrim vraća. 	neutralno
Stil pisanja ima u sebi svježinu, a opet zadržao je tradicijske vrijednosti i jezično bogatstvo bajkovitih priča. 	pozitivno
Šegrt Hlapić divan je protagonist, dječak kojeg je nemoguće ne voljeti. 	neutralno
Međutim, zapravo je njegova hrabra prijateljica Gita taj lik kojeg najbolje patim iz djetinjstva i koji me se najviše dojmio. 	pozitivno
Nedavno sam imala priliku ponovo pročitati dio ovog romana i bilo je to lijepo iskustvo. 	pozitivno
Čudnovate zgode šegrta Hlapića je roman koji me ponovo oduševio. 	pozitivno
"Uzme li se da kod nas ljudi što dobro pišu nemaju ideja, dok ljudi s idejama obično zlo pišu, da se dalje kod nas ni danas ne traži od dobre knjige jedino što odlikuje dobru knjigu - dobar stil - ove 'Čudnovate zgode' mogu se ubrojiti u one rijetke i prerijetke naše prozne knjige, što se idealizmom svog shvaćanja životnog, prostotom naravnog izraza i delikatnošću rijetkog humora mogu već sada smatrati klasičnima u gomili loše suvremene naše proze. 	neutralno 
Ta pripovijetka je dostojna klasičnog imena Ivana Mažuranića, boljih nema baš mnogo na našem jeziku. 	pozitivno
Napisati je mogaše samo genij matere. 	pozitivno
Genij hrvatske majke upućuje našu djecu, sitnu i bradatu, na jedina dva načina našeg spasa i održanja: na rad i poštenje. 	neutralno 
Ta prekrasna knjižica je demokratska, preporučujući nam radost i energiju, vjeru u sebe i zadovoljstvo sa siromašnim, ali radinim i poštenim životom. 	neutralno
Sviđa mi se njeno ime: Gita. 	pozitivno
Teško je reći velike stvari o nečemu o čemu stalno slušaš tijekom odrastanja. 	neutralno 
 Voljela bih da se sjećam tog prvog osjećaja kad sam je pročitala. 	neutralno 
Znam da je bila dobra, ali samo ne mogu reći koliko duboka, koliko dobra, kako bilo što.	Pozitivni 
No, kad je riječ o hrvatskoj književnosti, Ivana B. Mažuranić je jedinstvena. 	pozitivno
Pročitao za sat vremena. 	neutralno
Čudi me ako je ovo prvi stripovski uradak Čudnovatih zgoda Šegrta Hlapića. 	neutralno
Ne sjećam se da sam ikada vidio nekakav strip - ako je i bio, ja se ne sjećam. 	neutralno
I meni je drago što Hlapić više nije miš(koji je to klinac bio!?) već dječak, iz starog Broda na Savi koji je mukotrpno radio kod strogog majstora pokraj Ivanine kuće. 	pozitivno
Nisam stručnjak za crtež ili stripovsku formu, ali po meni je ovo odlično i sve u superlativima. 	pozitivno
Drži se knjige kao pijan plota i prati Ivanine riječi. Izvrsna je to prilika da se najmlađe uvede u Svijet Bajki i da pristupe čitanju kao nečemu zabavnom. 	pozitivno
Jer, kako i sam Hlapić kaže Giti na kraju romana: "Zato je najbolje, da se sad naigramo a poslije ćemo narasti kao i drugi ljudi." 	neutralno
Klasik iz pera hrvatskog Andersena. 	pozitivno
Tko može odoljeti ovome mišu koji nam se svima još kao malim uvukao u srca i postao simbol djetinjstva? 	pozitivno
Pa, nije mi to omiljena knjiga. 	neutralno
Čudnovate zgode šegrta Hlapića hrvatske književnice Ivane Brlić-Mažuranić, unuke pjesnika i bana Ivana Mažuranića, prvi je hrvatski dječji roman, ali i njegov prototip. 	neutralno
Navedeni roman koji možemo svrstati u dječji pustolovni roman, objavljen je prvi puta prije nešto više od sto godina, točnije 1913. godine. 	neutralno
Prvi hrvatski dječji roman označava prekid s dotadašnjim pravilima, ali i načinom pisanja dječje književnosti. 	neutralno
Autorica nastoji ispreplesti realistične događaje i likove s neobičnim događajima koji imaju obilježja bajke, primjerice dobre i loše figure, konkretan rekvizit koji junaka osposobljava za izvršenje radnje (čizmice), uporaba slijepih motiva (papiga tri puta govori dobro jutro), stalni atributi (Crni čovjek). 	neutralno
Hlapićev bijeg od kuće isprva je lagan, a zatim se pretvara u niz dogodovština, pretvara se u putovanje na kojem nailazi na mnogo neprilika i opasnosti u kojima život pokazuje svoje pravo lice. 	neutralno
Uz likove Hlapića, Gite, majstora Mrkonje, Grge i Crnoga čovjeka, u romanu ponekad intervenira i sama autorica; ponekad tumači misli i postupke svojih likova, pojačava napetost radnje, upozorava na slijed nekih događaja, što sve zajedno nije obilježje bajke, već romana. 	neutralno
U bajkama se radnja prikazuje bez slika, bez opisa pejzaža ili unutrašnjih proživljavanja junaka, dok na primjeru Čudnovatih zgoda šegrta Hlapića vidimo da Brlić-Mažuranić daje opise prirode, no navodi i poslovice i izreke koje preciziraju pojedine situacije. 	neutralno 
Jedna od najprevođenijih hrvatskih književnica, prikazom svojih junaka i najprije jednostavnim stilom, oslikala je ljudske pogreške, vrline i mane. 	neutralno 
Roman krasi vedrina i uzbudljivost, on je slika tipičnog dječjeg svijeta (bezbrižnog i razigranog), roman želi izreći humanost i vjeru u dobro, ali i kako u stvarnom životu ne završi sve tako lijepo kao u književnoj mašti. 	neutralno 
Što reći o ovoj divnoj knjizi, nego to da ju treba čitati, a ne pročitati. 	neutralno
Knjiga za svakoga i za svaku dob, čitala sam ju skupa sa svojom djevojčicom i obje smo baš baš uživale u ovom divnom dječjem klasiku. 	pozitivno
Šta god šegrt može da zamisli, to može i izvesti. 	neutralno
Još je glavnije da Hlapić ne zna, koliko ga dobra, a koliko zla čeka na tom putu. 	neutralno
Gdje se lud sa mudrijim bije, tu jednaka borba nije. 	neutralno
Gita nije kriva što ne zna raditi, kad je niko nije učio poslu. 	neutralno 
A sada, kad već zajedno putujemo, moram se ja brinuti za nju, pa ću joj dati polovicu svoje večere. 	neutralno 
Ne može ni kruška pasti pred tebe, ako ne sjediš pod njezinim stablom, kamoli da bi čovjek pao pred tebe iznenada. 	neutralno
Papige nose svoje znanje na jeziku, a ne u glavi. 	neutralno
Seljaci su uvijek dobra srca naspram siromašnoj djeci. 	neutralno 
Čuda ima svuda na svijetu, i svi ljudi zajedno ne bi mogli izmisliti toliko čudesa, koliko ih se svaki dan na svijetu događa. 	neutralno
U noći svaki čovjek tiše govori, jer takav je mir, da se svaka riječ daleko čuje. 	neutralno
Siromah čovjek malo se kada boji. 	neutralno
A tko god ide nekome u pomoć, taj se ničega ne boji, već samo da će zakasniti. 	neutralno
Oblaci ne idu kako ljudi govore, nego kako ih vjetar nosi. 	neutralno
Zato treba uvijek malo pričekati prije nego li se počne uzdisati. 	neutralno
Sretni ludi naime putuju, a da i ne znaju da putuju. 	neutralno
Kad čovjek čovjeka hvali, nikad ne zna je li pogodio. Zato je najpametnije, da obojica Bogu zahvale. 	neutralno
Jer svako je pismo još strašnije dok je zatvoreno i dok se ne zna šta je u njemu. 	neutralno 
Svaki život je u malome opetovanje sveopćeg života. 	neutralno
Svaki čovjek od zametka i poroda pa do smrti prolazi u minijaturi kroz repeticiju opće ljudske historije. 	neutralno 
Tko je zadržao djetinju dušu svoju? 	neutralno 
Ionako ima više onih koji deru cipele, nego onih koji ih peru. 	neutralno 
I konji postaju sijedi, premda nemaju takvih briga kao ljudi. 	neutralno
Ljudi se ne poznaju po odijelu nego po očima. 	neutralno
Genij hrvatske majke upućuje našu djecu, sitnu i bradatu na jedina dva načina našeg spasa i održana: rad i poštenje, preporučujući nam radost i energiju vjeru u sebe i zadovoljstvo sa siromašnim, ali radnim i poštenim životom. 	neutralno
Ovo mi je jedna od najdražih priča iz djetinjstva. 	pozitivno
Moja je mama ovo čitala mojoj braći i sestrama i meni kad smo dovoljno odrasli da mirno sjedimo u intervalima dužim od 5 minuta, i sjećam se da sam bio oduševljen Hlapićevim dobrim srcem i njegovom nepokolebljivom privrženošću dobroti čak i kad je svijet bio okrutan njemu. 	pozitivno
Morao sam otvoriti novu godinu s nečim ohrabrujućim i nostalgičnim. 	pozitivno
Ovo je bio savršen izbor. 	pozitivno
4,5/5, a bila bi puna 5 da Gita (glavna ženska uloga) ima više djelovanja. 	pozitivno
Hlapić, postolarski šegrt, bježi i biva upleten u mnoge opasne situacije. 	neutralno
Čak i kao odrasla osoba, zanimalo me što će se dogoditi i kako će Hlapić uspjeti. 	neutralno 
Kao i sve narodne priče, sve je dobro što dobro završi. 	neutralno
Sjajne male priče, moralno primjerene za svu djecu (i odrasle). 	pozitivno
Jedna od meni apsolutno najdražih priča, "Čudnovate zgode šegrta Hlapića" i dan-danas ostaje najvažnija knjiga za djecu (a i za odrasle!) koju apsolutno svi moraju pročitati. 	pozitivno
Tako slatka i slatka priča. 	pozitivno
Svidjelo mi se! 	pozitivno
Već sam zaboravio kako se optimistično knjiga završi. 	neutralno
Najpoznatija hrvatska knjiga za djecu, koju je napisao poznati hrvatski autor, poznat kao hrvatski Hanson Christian Andersen. 	neutralno
Zaista zabavno i srcedirljivo štivo. 	pozitivno
Jako pametna! 	pozitivno
Ali ja osobno i profesionalno ne volim tako moralno savršen glavni lik za dječju knjigu. 	Negativno
Prekrasna priča koja svakim novim čitanjem iznova svjedoči o genijalnosti svoje autorice. 	pozitivno
Klasik hrvatske književnosti. 	pozitivno
Slatka, ljupka dječja knjiga o postolarskom šegrtu koji napušta svog nasilnog gospodara i kreće u potragu za svojom srećom, imajući pritom mnoge avanture. 	pozitivno
Kako priča objašnjava, Hlapić je veseo kao ptica, hrabar kao vitez, mudar kao knjiga i dobar kao sunce. 	neutralno
Vidim zašto je ovo hrvatski klasik. 	pozitivno
To je sjajna knjiga za djecu. 	pozitivno
 Čitali su ga svi iz Hrvatske. 	neutralno
Ova knjiga je bila naše djetinjstvo. 	neutralno
Preporučam ga svima. 	pozitivno
Možete čak pronaći i englesku verziju. 	neutralno 
Možda nije dobar kao original, ali se u potpunosti isplati. 	pozitivno
Knjiga ima stvarno sjajne likove i radnju. 	pozitivno
Ovo sam pročitao za jedan od svojih razreda i bilo je tako lijepo čitati. 	pozitivno
Volio sam sve (dobre) likove. 	pozitivno
Ovo je za mene bio pravi emocionalni tobogan. 	neutralno
Knjiga je jako draga, a ako volite dječju literaturu trebali biste ovo pročitati! 	pozitivno
Ovu knjigu sam pročitao puno puta u svojoj mladosti. 	neutralno 
Ovo ilustrirano izdanje je prekrasno! 	pozitivno
Kad bi ga barem imale sve školske knjižnice. 	pozitivno
Knjiga je vrlo zanimljiva i maštovita. 	pozitivno
Vjerojatno jedna od najboljih knjiga koje sam pročitao u djetinjstvu. 	pozitivno
A ono ova mi nije bila nešto, da budem iskren nisam ju ni pročitao do kraja, bila mi je baš ful ful dosadna, ali kao učiteljica bi se ljutila kad bi vidjela da sam dao 1 zvjezdicu pa eto. 	Negativno
Cijeli život je putovanje. 	neutralno
Dosadna tko bi dala 1 zvjezdicu, ali evo dvije jer je Ivana ličanka. 	Negativno
Kad skontaš frajer se zove Hlapić. 	neutralno
Klasik s razlogom. 	pozitivno
Nakon skoro 50 godina ponovno pročitao klasik dječje hrvatske književnosti. 	pozitivno
Hlapić i njegova prijateljica Gita rade dobra djela po svijetu, pomažu svima i svakome daju ruku kad nekome treba. 	neutralno
Baš sam se sjetio ove knjige i želim s vama podijeliti da je to najdraža knjiga mog djetinjstva! 	pozitivno
Ima puno dobrih dječjih priča, ali nema puno dječjih priča koje možeš čitati i kad odrasteš i svakim čitanjem pronaći nešto novo. 	pozitivno
Uronjena u usmenu tradiciju, a opet toliko originalna i zanimljiva Ivana Brlić Mažuranić zaista je nešto posebno u svijetu književnosti za djecu (a ja bi dodala i za odrasle). 	pozitivno
Jedna od zanimljivosti autorice je i njena sposobnost da poveže slavensku mitologiju i usmenu tradiciju u naoko jednostavnu priču koja će privući i velike i male. 	pozitivno
Popularnost Ivana Brlić Mažuranić je u svakom pogledu opravdana. 	pozitivno
Nedavno sam je ponovo čitala i bila sam oduševljena. 	pozitivno
Njeni nezaboravni likovi i nezaboravne priče uljepšali su mnoga djetinjstva.	Pozitivnk
No, ono što me najviše oduševljava je dubina njenih priča- "Meni je draža moja nesreća nego sva sreća ovoga svijeta" je jedan od citata koji mi se urezao u sjećanje i nešto što me često navodi na razmišljanje. 	pozitivno
Šuma Striborova, vjerojatno i najpoznatija njena bajka, zaista je izvanredna, ali i ostale su jednako umjetnički vrijedne. 	pozitivno
Moja dva favorita su Regoč i Kako je Potjeh tražio istinu. 	pozitivno
Priče iz davnina su knjiga koji bi svatko morao pročitati barem jednom. 	pozitivno
Ne znam kome je ne bi preporučila. 	pozitivno
Dok se moj izazov da pročitam jednu knjigu koja se nalazi u svakoj zemlji bliži kraju, i koliko god očajnički pokušavam doći do toga, ne mogu iskreno reći da se ova knjiga računa kao Hrvatska. 	neutralno
Uzdah. 	neutralno
Bio sam uzbuđen što ću pročitati malo hrvatskog folklora i knjiga je isporučena. 	neutralno
Nadao sam se da je možda bilo nekih lokalnih okruženja, ali svi su bili u bajkovitom svijetu: jedan uz more, jedan u šumi, jedan u planini. 	neutralno 
Prva priča je bila cool. 	pozitivno
Sebični muž želi bolje za sebe i napušta svoju obitelj u potrazi za bogatstvom na dnu mora. 	neutralno
Ali nije sve onako kako se čini. 	neutralno
Ostavljena supruga prolazi kroz muku da ga spasi. 	neutralno
Naučene su neke ponizne lekcije. 	neutralno
Isto se događa i s ostalim folklornim pričama. 	neutralno
Ne budi pohlepan. 	neutralno
Nemojte biti nezahvalni. 	neutralno
Put do sreće je nesebičnost. 	neutralno
Pročitao sam nekoliko folklornih priča. 	neutralno
Ovaj je bio dobar u usporedbi. 	pozitivno
Dugo po čemu se ističe, ali nije ni nezanimljivo. 	neutralno
Čini se da je ovaj autor dobro poznat u Hrvatskoj i mnoga tamošnja djeca čitaju ga u školi i rado ga čitaju kao odrasli. 	neutralno
Kakav je ovo užas postmoderne? 	Negativno
Šalim se. 	neutralno
Kakav je ovo užas post mitološki (to već zvuči manje lijepo). 	Negativno
Meni se ovo ništa ne sviđa I ja bih u ovim pričama zasigurno bila antagonista moja bi ličnost bila predstavljena kao nekakva zmija. 	Negativno
Ako ćemo pravo nisam ja baš toliko zla. 	neutralno
A najkrindz moment je kad dolazi Mokos I sad ne moze da kaže" Pomoz bog", jer je jelte ona jelte slavenska boginja , pa umjesto toga kaže "Dobra ti kob???! ". 	Negativno
Na sta Neva Nevcica njoj odvraća " I tebi isto"? 	neutralno
Sto je meni bio hajlajt jezivosti ja se skroz naježila da ne kažem. 	Negativno
Mili bože čuda velikoga kako kob može da bude dobra?	Neutealno
Zaboravila Sam da napomenem da Mokos nije bas toliko zla kao ja i ona zmija, Ali je zato vrlo pakosna. 	neutralno 
I još nešto mi je palo na pamet da ovo bas ima bilo Kakve veze sa slovenskom mitologijom vjerojatno ne bi bila "popularna" knjiga u Engleskoj , da ima vjerojatno bi rekli da i nije nešto posebno, da ima boljih I da je njima to pomalo bezveze. 	Negativno
Možda je to izrečeno vise da bi se knjiga kod Nas popularizovala, jer opsta je poznata činjenica da se kod Nas sve voli Sto odobri zapad, mada ja vise prosto ovo kažem zato što ne mogu da vjerujem da ovo neko čita zato sto je nevjerojatno , jer nije zapravo je vrlo bljedunjavo I brzo zaboravile I da ste ih čitali. 	Negativno
Djeluje kao da je neko sklepao i nakalemio nekoliko različitih božanstava o kojima ne zna ama baš ništa. 	Negativno 
I kakve su ovo budalaštine ona žena Njemica te joj se živa riječ povrati. 	Negativno
Nemoguće je izbjeći ove priče ako živite u istočnim dijelovima Europe i nemoguće ih je zaboraviti, jer na neki način stvaraju vaša sjećanja iz djetinjstva. 	neutralno
Postoje knjige koje ne biste trebali ponovno čitati nakon mnogo godina. 	Negativno
Ovo je jedna od tih knjiga. 	neutralno
Volio sam te priče kao dijete, apsolutno sam ih volio. 	pozitivno
Sad su mi se svidjela samo dva; i jedva. 	pozitivno
Iako sam Bosanac i Slovenac nisam bio toliko upoznat s hrvatskim pričama pa sam jako volio zaroniti u njih i otkriti nove priče za ispričati. 	neutralno 
Ova knjiga je bezvremeni klasik i ima nezamjenjivu sentimentalnu vrijednost. 	pozitivno 
Za mene predstavlja djetinjstvo i sve uspomene koje dolaze uz to. 	pozitivno 
Svaki put kada ju čitam naviru osjećaji nostalgije, te vjerujem da bismo na ovu knjigu trebali gledati kao na vrstu nacionalnog blaga i sačuvati ju za nadolazeće generacije. 	pozitivno 
Najveće smeće hrvatske književnosti. 	Negativno
Precijenjena babetina s kojom nas maltretiraju u vise razreda osnovne ali i srednje škole. 	Negativno
Još od prvog čitanja urezala mi se scena jezerca s otočićem i crkvicom na njemu, te malenu Rutvicu kako zvonjavom tjera zlo s planine. 	neutralno
Na moje neizmjerno veselje i nevjericu pronašla sam to mjesto u stvarnosti, prije par godina posjetom Visovcu. Neutralni
Ne znam ima li uopće smisla da nadodajem ili pišem išta o Pričama iz davnine. 	neutralno
Klasik hrvatske dječje književnosti, priče uz koje smo svi odrasli, ali im se svakako možemo vratiti i svaki put naučiti nešto novo iz njih. 	pozitivno
Ivana Brlić-Mažuranić uistinu je genijalka bez premca. 	pozitivno
Priče su prekrasne. 	pozitivno
Šteta što su teško razumljive današnjoj djeci, pojmovi koji se spominju u knjizi su jedva razumljivi i nama malo starijima. 	Negativno
Knjiga koja bi morala cijeloj regiji, ako ne i svim Slavenima, biti dio lektire. 	pozitivno
Ako niste, pročitajte je obavezno, i potrudite se da je pročitaju i vaša djeca. 	pozitivno
Ovo su zabavne bajke. 	pozitivno
Pročitao sam dosta takvih priča u svoje vrijeme, a ove su dobre kao i sve koje sam pročitao. 	pozitivno
Ima nečeg posebnog u čitanju bajki iz dijela svijeta o kojem čovjek mnogo zna. 	pozitivno
Moram priznati ograničeno izravno iskustvo s Hrvatskom i njezinim okolnim (i stalno promjenjivim) susjednim zemljama. 	neutralno
Mislio sam da su ranije priče bile bolje od nekih kasnijih, ali moguće je da je to samo to što na kraju dana većina bajki ima sličnu strukturu i čovjek ih može pročitati samo toliko prije nego što ih malo pronađe koji se ponavlja. 	neutralno
Čuvam ih za sljedeći put kad me zamole da djeci čitam naglas. 	pozitivno
Mojim učenicima petog razreda u Chicagu ovo bi se svidjelo. 	pozitivno
Šuma Striborova mi je od djetinjstva jedna od omiljenih priča. 	pozitivno
Imam nevjerojatno žive uspomene iz djetinjstva vezane za Malika Tintilinića i kukanje dok mi neko iz porodice ne pročita ponovo Šumu Striborovu. 	pozitivno
Naravno, i druge priče iz ove knjige su fantastične, ali ipak, meni je Šuma Striborova uvijek bila omiljena. 	pozitivno
Ne bih mogla da ovome dam manje od pet zvjezdica ni u kom slučaju. 	pozitivno
Također, imam osjećaj da je to možda nešto izmišljeno iz djetinjstva ali, da li se itko sjeća časopisa Malik Tintilinić? 	neutralno
Ivana Brlić Mažuranić je jedna od najvećih hrvatskih spisateljica. 	pozitivno
Opravdala je svoju nominaciju za Nobela i jako mi je žao da ga nije dobila. 	pozitivno
Zaslužila ga je. 	pozitivno
Čitajući njene Priče iz davnina, Ivana je omogućila svojim čitateljima ulaz u njen svijet mašte, koju je sigurno čuvala, ali i začela još u djetinjstvu kroz život u srednjovjekovnom Ogulinu, gradu vještica i vila. 	neutralno
Svaka priča je poučna, originalna, bajkovita, čarobna. 	pozitivno
Ivana je odlična. 	pozitivno
Nebitno je jeste li dijete ili odrasla osoba, ove priče su prekrasne i prikladne za svaki uzrast. 	pozitivno
Odlične priče. 	pozitivno
Za razliku od Hlapića, postoji cijela nijansa karaktera. 	neutralno 
Posebno mi se svidjela "Kako je Potjeh tražio istinu", u drugom čitanju, kao psihologu koji radi s djecom tinejdžerske dobi. 	pozitivno 
Na mene je u mom djetinjstvu pak jako utjecala sama "Šuma Striborova", posebno bakin odabir na kraju. 	pozitivno 
Ta ideja mi se urezala kao neka misao vodilja, oblikovala moje uvjerenje da nas svo dobro i svo zlo u životu čini onim što jesmo sad, te da ako cijenimo sebe u sadašnjem trenutku ne želimo mijenjati ništa u prošlosti. 	pozitivno 
A postoje i stvari koje su jače od trenutne dobrobiti, ljubav. 	neutralno
 Ivana Brlić-Mažuranić apsolutna je kraljica pisanja. 	pozitivno 
Ne samo da su njene priče idealne za djecu, već su savršene i za odrasle, i bilo koje dobi! 	pozitivno 
Svaka priča odzvanja sa svojom poukom, a prekrasno pisanje u potpunosti te uvodi u zamišljene svjetove Ivane Brlić-Mažuranić kao da si stvarno tamo. 	pozitivno 
Potrebito čitanje za svakoga! 	pozitivno
Volim istraživati kulture prije putovanja, a kako ove jeseni planiramo putovanje u Hrvatsku, mislio sam da bi ovo bilo zabavno štivo. 	neutralno 
Nažalost, bez krivnje autora/prevoditelja, ove sam priče smatrao prilično dosadnima. 	Negativno 
Kao što je moj muž rekao, "možda tada nisu znali kako pričati dobre priče..." 	Negativno 
Izvrsna zbirka bajki temeljena na hrvatskom folkloru i slavenskom mitu. 	pozitivno 
Dobar je ali nije ostavio dojam na mene. 	neutralno 
Jednostavno izvrsno. 	pozitivno 
Ovo je bila knjiga koju sam čitao za školu. 	neutralno
U ovoj knjizi vidim puno potencijala. 	pozitivno 
Mrzio sam stil pisanja i jedva sam razumio neke riječi i rečenice. 	Negativno
Promijenio mi je život kad sam je čitao kao dijete. 	neutralno 
Najveći fan apsolutno obožavanje. 	pozitivno 
Volim Ivanu. 	pozitivno 
Nevjerojatna zbirka starih priča. 	pozitivno 
Postoje knjige koje smo obožavali kao djeca, ali kada ih čitamo kao odrasli  jednostavno izgube tu čar. 	neutralno
Ovo nije takva knjiga. 	neutralno 
Dobro je. 	pozitivno
Ovo je bila prva hrvatska knjiga (ili bilo koja knjiga na hrvatskom) koju sam pročitao nakon dugo vremena. 	neutralno
Odlučila sam nešto čitati svojoj bebi kad odbija spavati ili dok se budi. 	neutralno 
Čitanje naglas zapravo ga je učinilo još ugodnijim, a autor je napravio tako dobar posao koristeći i prikazujući jezik. 	pozitivno 
Doduše, stil je pomalo arhaičan za početak 20. stoljeća, ali to je vjerojatno namjerno s obzirom na vrstu knjige. 	neutralno
To je hrvatski klasik i čitao sam ga kao klinac, ali imam notorno loše pamćenje što se tiče knjiga i filmova, pa sam se samo nekih priča sjećao, i to nejasno. 	pozitivno
U svakom slučaju, priče su sjajne, a posebno mi se svidjelo kako pojedini likovi prkose uobičajenom crno-bijelom konceptu bajki. 	pozitivno 
Naravno, neke su priče bile bolje, neke gore, a volio sam antiratnu poruku u "Regoču" i način na koji je "Potjeh tražio istinu" napisana. 	pozitivno 
Sveukupno nisam bio razočaran nijednom pričom, ali da se moram zajebavati, "Ribar Palunko i njegova žena" bi vjerojatno dobio najnižu ocjenu jer mi se jednostavno nije toliko svidjela. 	Negativno
Nakon tridesetak godina ponovno sam uzeo "Priče iz davnine" u ruke. 	neutralno 
Neke od priča sam u potpunosti zaboravio, no još uvijek imaju svoju draž, koketirajući sa slavenskom mitologijom. 	pozitivno
Na žalost, rječnik je postao arhaičan, te čak i starijima može predstavljati problem... kako bi to sjelo djeci koja sama čitaju ostaje mi nepoznanica. 	Negativno
Sličnu ideju uzimanja djelića slavenske mitologije te pisanje o tom svijetu napravila je oko 2000te i Lidija Bajuk, s knjigom "Kneja"... možda se nekome dopadne i to djelo. 	neutralno
Kako je sjajno i ritmično pisala. 	pozitivno 
Sve su mi priče fantastične, ali najdraža mi je "Regoč" (i Kosjenka) I "Jagor" u kojoj su kravica i kozica heroine. 	pozitivno 
'Otvori Jagor oči i ugleda nad sobom riđu bradicu i dva vita roga i još dva oka, da su dva anđela božja, ne bi mu milija bila. 	neutralno 
Skoči dijete, digne ruke i reče: "Izbavi me, rano moja." 	neutralno
Želim djecu samo da imam kome čitati ove priče. 	pozitivno 
Zbirka narodnih bajki koje je prepisala i dopunila velika hrvatska književnica Ivana Brlić-Mažuranić. 	neutralno 
Ova je knjiga namijenjena mlađoj djeci, ali je jedan od najboljih primjera kako Ivane Brlić-Mažuranić, tako i hrvatskih narodnih bajki, pa je vrijedi pročitati znanstvenicima ili svima koji se živo zanimaju za hrvatsku književnost ili dječju književnost. 	neutralno 
A svakako je i ugodan: živopisan, brz i romantičan. 	pozitivno
Čitao sam te priče kad sam bio mali. 	neutralno
Moja baka mi ih je čitala kao priče za laku noć. 	neutralno
Ah sjećanja. 	neutralno 
Jedna od mojih najdražih knjiga iz djetinjstva. 	pozitivno 
Proklet! 	Negativno 
Ovo je tako staro i mrzim to. 	Negativno
Ovo smo morali pročitati u našem razredu. 	neutralno
Omiljene hrvatske bajke. 	pozitivno
Uključuje i hrvatsku (slavensku) mitologiju, što je čini još zanimljivijom. 	pozitivno
Ima više priča. 	neutralno
Pa... ovo mi se svidjelo, ali nije bilo kao druge knjige koje sam čitao. 	pozitivno
Malo sam razočarana. 	Negativno
Vrlo ugodno vrlo djetinjstvo. 	pozitivno 
Vrhunac naše dječje književnosti, najljepše bajke ikad! Priče koje ostaju za cijeli život. 	pozitivno
Ne mogu otvoriti da čitam. Neutrlano
Ovo je djelo jednog od najboljih pisaca u povijesti Hrvatske. 	pozitivno
Napisano je za djecu i mislim da je pisanje Ivani dalo utjehu. 	pozitivno 
Aorist i imperfekt nisu jedina glagolska vremena. 	neutralno
Sviđa mi se ugođaj bajke ali Potjeh je prenaivan za trpiti. 	Negativno
Avanture starca i njegova tri unuka. 	neutralno
Vjerojatno najbolja priča u zbirci. 	pozitivno
Dosadno, djetinjasto, glupavo, kratko. 	Negativno
Odlična! 	pozitivno
Ovo je jedna od prvih knjiga koja je promijenila moj pogled na život i duboko utjecala na mene. 	pozitivno
Ne znam je li to samo zato što sam bio tek tinejdžer ili to stvarno ima onaj učinak koji mijenja život za svaku dob. 	neutralno
Ova knjiga ima vrlo zanimljivu priču za mene i nikada mi neće dosaditi da je ispričam. 	pozitivno 
Pronašao sam ovu knjigu na klupi u parku kad sam imao dvanaest ili trinaest godina - ne mogu reći. 	neutralno 
Pročitao sam knjigu iako nisam u potpunosti upio o čemu se radi, nikad mi ne dosadi čitati iznova i iznova kako bih pronašao ono što sam propustio. 	pozitivno
Imao sam je par godina i to mi je bila najdragocjenija knjiga. 	pozitivno 
Izgubio sam je kad sam bio završni razred srednje škole, što je vrlo čudno jer nikad ne gubim knjige i vrlo sam oprezan s tim. 	neutralno
Osobito o ovoj knjizi kao što već znate. Neutralnl
A onda me pogodilo: netko ju je izgubio ili ostavio u onom parku -za mene- i ja sam je pronašao, nekako sam je izgubio -za nekoga- i netko ju je pronašao - nadam se netko kome je duboko stalo do knjiga i nadam se netko koga će to pogoditi i brinuti se o tome jednako kao i ja. 	neutralno
Svatko tko je pročitao ovu knjigu mogao bi razumjeti kada kažem da je to duhovna knjiga, a duhovnost ove knjige nije samo ostala na stranicama za mene, ona je prodrla u moj život, preuzela kontrolu nad njim na jako dugo razdoblje. 	neutralno
I iako ga više ne posjedujem, još uvijek nosim njegov duboki učinak u sebi i uvijek ću. 	pozitivno
Znam da mogu pronaći ovu knjigu na internetu i bio sam na rubu da je kupim mnogo puta, ali sam svaki put zatvorio te web stranice. 	neutralno
Želim je pronaći u rabljenoj knjižari, želim je osjetiti u svojim rukama i osjetiti isto zadovoljstvo i uzbuđenje kada sam je prvi put pronašao u onom parku. 	neutralno 
Dođi mi ponovno, Klara, kao prije osam godina. 	neutralno 
Ovu biste knjigu svakako trebali pročitati. 	pozitivno 
Kada je ovaj roman u pitanju, izdvojila bi dvije komponente koje ga čine posebno uspješnim, a to je zanimljivost teme i istančana karakterizacija glavnoga ženskoga lika. 	pozitivno 
Tema alternativne duhovnosti je veoma zanimljiva i poprilično originalna, a pisac se u ovoj knjizi doista upustio u nju, tako da ti nadnaravni dijelovi zapravo postaju dio radnje te nisu nikako samo nekakav prolazni motiv. 	neutralno 
Govori se tu o aurama, meditacijama, energijama, pojavama koje bi se mogle nazvati new age duhovnošću, ali opet nije to nikakav banalan pristup alternativnim vjerovanjima i duhovnosti, već svi ti elementi djeluju dosta uvjerljivo i dobro su uklopljeni u sam zaplet i radnju romana. 	neutralno 
Ostavlja se prostor slobodnom tumačenju, rekla bi, te čitatelj sam može interpretirati viđeno kako želi, ali svakako se pretpostavlja da su te neke duhovne pojave koje se ne smatraju uobičajenima i više nego stvarne, barem u kontekstu ovoga djela. 	neutralno 
Dakle, tematika je dosta zanimljiva i postavlja jedan zanimljiv okvir u kojem naš glavni ženski lik dolazi do izražaja. 	neutralno 
Gavran je poznat kao izvrstan poznavatelj ženske psihologije, a u ovome romanu to posebno dolazi do izražaja. 	neutralno 
Klara je ne samo glavni lik romana, cijeli roman je zapravo ponajviše o njoj, njega životna priča je okosnica svega, pa iako ovaj roman ima i tu jednu duhovnu dimenziju, a uspješno prikazuje i određeni kritični period naše povijesti, ipak je on prije svega priča o Klari. 	neutralno 
Da je Klara kojim slučajem manje punokrvni lik, roman bi bio znatno manje dojmljiv, ali jer je njena karakterizacija tako uspješna, ovo djelo poprima novu dimenziju i prerasta u zaista zaokruženu i kvalitetnu priču. 	neutralno 
Sveukupno, Klara mi se jako svidjela i kao lik i kao roman. 	pozitivno 
Čita se s lakoćom, ali ostaje duboko u sjećanju. 	pozitivno 
Koliko se sjećam, ovo je jedan od privih romana Mire Gavrana kojega sam pročitala. 	neutralno
Nakon svih ovih godina, još uvijek se živo sjećam koliko me iznenadio u 	pozitivnom smislu. 	pozitivno 
Ovo je najčudesnija hrvatska knjiga koju sam ikad pročitao i vjerojatno će tako i ostati! 	pozitivno 
Okeee, što sam ja upravo pročitala? 	neutralno
Na moj odabir ove knjige utjecale su dvije stvari. 	neutralno 
Prva, još davno na faksu kad ju je čitala kolegica i prijateljica Mirta. 	neutralno
Ne sjećam se njenog mišljenja o knjizi, ali se jasno sjećam da ju je čitala i da sam ju i ja željela pročitati. 	neutralno
Druga stvar je ta da sam na početku ove godine odlučila čitati više hrvatskih autora pa sam od jedne druge prijateljice, koja ima poprilično opsežnu zbirku knjiga hrvatskih autora (i susjeda), totalno nasumice odabrala desetak knjiga. 	neutralno 
Klara je bila među njima. 	neutralno 
Gavrana još nikad nisam čitala (osim par dječjih) i prijateljice su mi rekle da je Klara poprilično nesretan odabir za počinjanje. 	Negativno
I totalno kužim što su mislile. 	neutralno
Uzela sam ju u ruke naslijepo, ne pročitavši ništa o njoj, i poprilično me iznenadio obrat negdje na polovici knjige. 	neutralno 
Moj čitateljski doživljaj podijelila bih na dva dijela. 	neutralno 
U prvoj polovici mi se Klara uopće ne sviđa. 	Negativno 
Razumijem da je majčina nesreća utjecala na Klarin odabir životnog puta i muškaraca, ali majko mila da baš ništa nije naučila iz svojih (i majčinih) pogrešaka. 	neutralno 
Kao, prvi muškarac me iskoristi zbog mog neznanja i nesnalaženja. 	neutralno
Pa zato mrzim sve muškarce i mislim da su svi isti kao on. 	neutralno 
Onda se svejedno dam upecati od drugog iskorištavača. 	Negativno
I prepoznajem da me iskorištava, ali ne činim ništa da se maknem od njega. 	neutralno 
Kao, slaba sam, ali pasivno agresivna. 	Negativno
I opet kad ta veza propadne, pogađate, opet mrzim sve muškarce. 	Negativno
E sad s drugim dijelom počinje taj iznenadni obrat, koji se u prvom dijelu pokaže samo u tragovima i izgubi se u potpunosti u Klarinim komplikacijama s muškarcima. 	neutralno 
I onda odjednom neke meditacije, neka izliječena, neke drugi svjetovi, mantranje. 	neutralno
Onak, što? 	Negativno
I da, tko još u govoru koristi riječi “imade”, “znade”, “dadem”? 	neutralno 
Ne sjećam se ni da su tako pričali moji roditelji, pa ni u ono vrijeme prije rata. 	neutralno 
Ja ne znam što bih s ovom knjigom. 	neutralno 
Globalni ciljevi: autor s naših prostora, autor s ne engleskog govornog područja. 	neutralno
Mislim da nikad nisam pročitala knjigu u kojoj je napisano toliko toga, a da zapravo ništa nije rečeno. 	Negativno
Glavni lik romana, Klara, ženska je osoba koju teško možemo nazvati likom. 	Negativno
Pratimo ju od njenog djetinjstva do odrasle dobi, no u cijelom tom procesu, ne saznajemo zapravo tko je ona. 	neutralno
Događaju joj se otprilike sve loše i nepovoljne stvari koje možete zamisliti - od rastavljenih roditelja i lošeg odnosa s majkom, preko dečka koji ju zanemaruje do gubljenja djeteta. 	neutralno 
Međutim, sve te loše stvari kao da su tu samo da bi joj bespotrebno nanosile patnju. 	neutralno
Ljudi u stvarnom životu često bespotrebno pate. 	neutralno 
Ali baš zato što je život pun bespotrebne patnje, životi književnih likova, po meni, ne bi trebali biti takvi. 	neutralno 
Ne, ne mislim da ne trebaju postojati likovi koji pate i knjige koje su tužne; mislim da patnja u književnom djelu treba imati neku ulogu - ako ništa drugo, ulogu izgradnje karaktera lika. 	neutralno
Patnja koja nema ulogu previše me podsjeća na sadizam (da, smatram Georgea R.R. Martina sadistom). 	Negativno
Klara ovdje gotovo neprestano pati, ali ne vidimo kako je ta patnja utjecala na nju. 	neutralno
Govori da je tužna, nesretna, uništena, podala se alkoholu i "život joj se raspršio u jednom trenu", ali ništa od toga ju ne oblikuje. 	Negativno
Zbog svega toga, nakon pročitane cijele knjige o jednoj ženi, zapravo nemam osjećaj da ju poznajem. 	neutralno 
Kad u knjizi upoznate dobro napisanog i izvedenog lika, imate osjećaj da znate kako bi se taj lik ponio u svakodnevnim situacijama. 	neutralno
Npr., da čeka u dugačkom redu u pošti, Filip Latinovicz bi stajao mirno, melankoličnog pogleda uperenog u nešto neodređeno, vjerojatno gležnjeve službenice koji proviruju ispod šaltera, i imao bi jedan od svojih unutarnjih monologa o ljudskoj prirodi. 	neutralno
Toliko bi se zadubio u svoje misli, u sjećanja duboko zakopana na koja ga je asocirala boja pulovera čovjeka ispred njega, da bi ga iz sanjarenja probudio tek glasan uzdah službenice nakon što se nije odazvao na njen drugi, monotoni "Dobar dan, izvolite!"Hermione iz Harryja Pottera stajala bi nemirno na mjestu, pogledavala bi na sat, a nakon što shvati da će zakasniti na predavanje, prišla bi šalteru, ponudila svoju pomoć, naučila što treba raditi i pomogla da se smanji red. 	neutralno 
Što bi radila Klara da stoji u redu na pošti? 	neutralno
Ne znam. 	neutralno
Jer ne znam tko je ona. 	neutralno
Osim što ne znam tko je Klara, ne znam ni o čemu je ova knjiga. 	neutralno
Ako je o životu jedne žene, zašto završava u trenutku kad pronalazi muškarca? 	neutralno
Ako je o životu jedne žene, zašto je više poglavlja posvećeno idiotu od njenog prvog dečka, nego cijelom njenom odnosu s majkom? 	neutralno
Tužno je kad su životi žena reducirani samo na erotske zaplete i rasplete. 	Negativno
Ako je o Klarinom putu prema duhovnosti, kako razni osvrti često pišu, zašto te duhovnosti nema nigdje do zadnje petine romana? 	neutralno
I zašto cijelo iskustvo ostaje na razini anegdote? 	neutralno
Čak i ako stavim potpuno na stranu svoju odbojnost prema aurama, čakrama, bioenergijama i ostalome, cijeli taj izlet u alternativnu duhovnost mi se čini mističnim i ne baš logičnim uz ostatak romana. 	Negativno
Iako bi trebao biti tema romana, kako navode osvrti na zadnjim koricama. 	neutralno
No, da je cijela ta Klarina priča bolje napisana (a ovdje mislim isključivo na stil pisanja), možda mi nelogičnosti ni bespotrebne stvari ne bi tako loše sjele. 	Negativno
Ali kako da se uživim i emotivno vežem za roman gdje je prosječna duljina rečenica 5 riječi (ne kažem da su duge rečenice pokazatelj dobrog stila, naprotiv, ali lijepo ilustriraju kompleksnost izričaja), događaji se nižu jedan za drugim, bez pravog pripovijedanja, opisivanja, smislenih dijaloga, prijelazi s događaja na događaj su nagli, grubi i neočekivani (ali ne neočekivani kao plot-twistovi; neočekivani da izazivaju "wtf, zašto sad ovo, kakve to veze ima s ičim" reakciju), a zbog opisa i Klarinih misli tijekom seksa, pardon upražnjavanja čina fizičke ljubavi, kako bi ga Gavran vjerojatno nazvao, sam se pitala je li sa mnom sve u redu jer tijekom seksa ne razmišljam o svojoj vagini kao "središtu svoje intime koje su njegovi poljupci rastvorili poput tek probuđenog lopoča" (da, to je doslovan citat). 	Negativno
Sve u svemu, čini mi se da je Gavran obećao izdavaču rukopis, brutalno kasnio i na kraju morao 250 stranica napisati navrat-nanos u tjedan dana. 	Negativno
I to je u redu, svi mi odgađamo svoje obaveze. 	neutralno 
Samo, kad ja odgađam pisanje seminara i napišem ga noć prije roka, profesori ga ne prihvate i kažu da ga popravim, a Gavranov roman (stvarno ne shvaćam zašto) ljudi obožavaju i doživi osam izdanja. 	Negativno
I samoj mi je pomalo teško povjerovati da mi se nije svidjela ova, toliko hvaljena, knjiga Mire Gavrana. 	Negativno
Još više zato što sam bila gotovo sasvim uvjerena kako je nemoguće da mi se nešto njegovo ne svidi. 	Negativno
Sve što sam dosad pročitala iz njegova "pera", približilo mi ga je, zavoljela sam ga, stil kojim piše (o čemu god to bilo) bio mi je blizak. 	pozitivno
Ali ovo je takvo razočaranje. 	Negativno
Kao da je knjigu napisao netko drugi, a ne Miro Gavran. 	Negativno
Čudne, siromašne, čak prejednostavne rečenice (iako znam da ovo može zvučati kao da ne znam što tražim, ali nije tako - upravo u jednostavnosti čovjek treba biti majstor!), poput suhoparnog novinskog članka. 	Negativno
Tema u koju je ovdje ušao (ljudi koji se bave meditacijom, pa ulaze u neke druge sfere, svjetove, pipaju drugima aure, iscjeljuju, skoro pa su nekakvi polubogovi ovdje na zemlji) nešto je o čemu se - ako se već ideš time baviti - moraš pozabaviti malo dublje, naučiti neke stvari, proučiti ih barem. 	neutralno
Ovako, dobila sam dojam da je to sve njemu (kao i Klari, glavnoj junakinji, čiji je knjiga nešto kao životopis) igra, ali na način koji je shvaćaju djeca - to je tako, nikako drukčije, mi smo ovakvi, drugi su onakvi... uopće ne znam što bih rekla, osim da sam čitajući stoput ponovila, "Ma daj, molim te! Kamo ideš s tim? Evo, opet bedastoće!" 	Negativno
Nikako, žao mi je. 	Negativno
Istina, knjiga se brzo čita, rekoh, i prejednostavna je, rekla bih (bez želje i namjere da ikoga vrijeđam) poput dnevnika neke, recimo, četrnaestogodišnjakinje. 	neutralno
Eh. 	neutralno
Vrlo privlačna priča o odrastanju djevojke vješto pisana u prvom licu. 	pozitivno
Unutarnji svjetovi su toliko fino ispleteni kako bi čovjek pomislio da ih je pisala žena. 	pozitivno 
Možda uistinu jest pomogla autorova supruga. 	neutralno
Ako i jest, sjajno je uklopljeno. 	pozitivno 
Toliko da se opis muških likova neugodno uvlači u misli, naročito muškom čitatelju poput mene. 	pozitivno 
Tjera na preispitivanje i svrstavanje. 	neutralno
Pomalo dojam remete pokušaji dubokih uvodnih mudrosti u svakom poglavlju koji u meni ipak nekako ostave osjećaj plićine. 	Negativno
U početku priče lagana mističnost proročanskih snova dodaje posebnu draž. 	neutralno
Uvođenje meditacije razblaži, dok reinkarnacija nekako baš razvodni. 	neutralno
Još da je u knjizi bilo pomalo sarkastičnog humora i povremene zezancije, umanjio bi se dojam magije. 	neutralno
Nema veze, rado ću jednom opet pročitati ovu knjigu za koju godinu iako mi se zvjezdica manje čak čini prestrogom ocjenom. 	pozitivno
Dobra psihologizacija ženskog lika. 	pozitivno
Jednostavan jezik i naracija. 	pozitivno
Drugi dio romana mnogo lošiji zbog uvođenja meditacije u priču koja djeluje kao nadriliječništvo i magija, čime roman gubi na uvjerljivosti i ozbiljnosti. 	Negativno
Zanimljiva i neobična knjiga koja se lako čita. 	pozitivno
Prvi put sam ju čitala prije 15 godina, dok sam se osjećala pomalo kao Klara. 	neutralno
Sumnjala sam da o njoj neću misliti isto nakon što ju ponovo pročitam u odrasloj dobi, ali sam se srećom prevarila. 	neutralno
Knjiga nije za svakoga i neće se svakome svidjeti, ali isplati joj se dati priliku. 	pozitivno
Jedna od najdražih mi knjiga Mire Gavrana. 	pozitivno
Sigurno ću je ponovno čitati. 	pozitivno
Duboka, puna emocija, a čita se lakoćom. 	pozitivno 
Divna. 	pozitivno
Savjet - ne pitajte knjižničarku da vam predloži knjigu. 	Negativno
Reinkarnacija, žena koja nema sreće u ljubavi, meditacija, bol. 	neutralno
Sretan kraj. 	pozitivno
 Ovakve bi se lektire Čitale! 	pozitivno
 Barem ja bih! 	pozitivno
 Judita. 	neutralno
U hrvatskoj književnosti ovaj lik iz Biblije (sami Židovi priču o Juditi drže nepotvrđenom) ima posebnu dimenziju i važnost. 	neutralno
Ime koje nam svima pada na pamet je Marko Marulić, poznat i kao otac hrvatske književnosti. Ispričati njenu priču iznova, pretvoriti Juditu u glavni lik suvremenoga romana, nije nimalo lagano, ali Gavran je u tome uspio. 	neutralno
Treba hrabrosti za uhvatiti se u koštac s ovim likom. 	neutralno
Kakav je lik Gavranova Judita? 	neutralno
Lik koji raste pred našim očima, te postaje izrazito složen i višeslojan na samom kraju romanu. 	neutralno
Od samoga početka pak, ona nam se obraća svojim riječima, priča nama čitateljima svoju životnu priču, kako sama kaže jer ima potrebu podijeliti je sa nama, a ujedno kao što ćemo saznati podijeliti i svoju veliku bol i tragediju. 	neutralno 
Gavran nam, kroz Juditine vlastite riječi, vješto opisuje njeno djetinjstvo i njeno djevojaštvo, slika nam sliku duboko moralne osobe koja na nekoj razini ne shvaća okrutnosti i surovost društva u kojem živi, to jest ona osjeća nepravdu, ali nema riječi, mašte ili shvaćanja da tumači okrutnost kao takvu i shvati o čemu se zapravo radi. 	neutralno 
Ona ne poznaje drugačije društvo, ona nije nikada svjedočila ikakvome svijetu osim onome u kojem je ona živjela. 	neutralno
Stoga se ona i ne protivi kamenovanju kada ga vidi, dapače ona ga smatra nečim normalnim, čak i kada sama ne može podignuti kamen. 	neutralno
Ona vjeruje u zakon i proroke, te ne vidi svijet onkraj zakona, barem ne svijet koji bi imao ikakvoga smisla. 	neutralno
Za nju je kamenovanje dio njena svijeta i ona ga ne dovodi u pitanje, jednako kao što i druge zakone ne propituje, ne zato jer nije osjećajna ili inteligentna, već zato jer je kao i svi mi duboko određena svojim odgojem i podrijetlom, a upravo tu leži i njena tragedija. 	neutralno
Svi smo mi više biološki i kulturno programirani nego što to volimo priznati, a i čak i duboko moralne osobe često ne vide koliko bešćutan i besmislen može biti društveni moral, jer moralnost je zapravo možda samo druga riječ za duboku osobnu odgovornost. 	neutralno
Gavranova Judita je od djetinjstva na neki način izdvojena, zbog njezine ozbiljnosti svi je posebno poštuju, a ona odrasta u poslušnu djevojku koja slijedi stroga pravila moralnosti društva kojemu pripada. 	neutralno
Zaljubljuje se u bratova prijatelja, ali kada on zakasni sa prošnjom za svega jedan dan, Judita bez pogovora prihvaća očevo objašnjenje kako ju je već obećao bogatom mladiću iz ugledne obitelji. 	neutralno 
U njoj se od početka osjeća nekakav potencijal, nešto što je uzdiže od drugih, ali ona nikako nije spremna sama određivati što je moralno, a što ne, u njoj se očitava snažna pripadnost zajednici, unatoč toj njenoj određenoj odvojenosti od društva i odrastanja u kojem joj je jedini iskreni prijatelj bio brat. 	neutralno
No, njeno djevojaštvo završava i Judita napušta voljenu obitelji te odlazi živjeti s mužem. 	neutralno
Tu slijedi šok za djevojku jer brak nikako nije ono što je zamišljala. 	neutralno
Prva bračna noć je zapravo silovanje, iako ona tu riječ ne poznaje u kontekstu svoga novoga položaja i nema načina da progovori o tom novom, a neželjenom aspektu svoga života. 	neutralno
Njezino nenadano udovištvo i rana smrt muža dolaze joj kao olakšanje, a opet zbog toga osjeća grižnju savjesti i pokorama nastoji opravdati svoje prirodno osjećanje. 	neutralno
Pokore i molitve joj doista i donose neko olakšanje. 	neutralno
Tu se već počinje ocrtavati njen karakter i plesti njena legenda. 	neutralno
Judita puno toga vidi, ali je bojažljiva, nevična donositi zaključke i posve nevoljna biti nositelj ikakve promjene. 	neutralno
Ona je zapravo divno ljudska u svojoj nesavršenosti. 	neutralno
Kao i mnogi, Judita živi dva života i ima dva lica. 	neutralno
Jedno koje pokazuje u javnosti, a drugo koje čuva za sebe. 	neutralno
Judita nije licemjer, ona jednostavno još nije pronašla način da podijeli i to drugo lice sa svijetom, a možda taj način i ne postoji, možda je dovoljno mudra da zna da se neke stvari i ne mogu podijeliti, da neke tajne duše uvijek ostaju tajne. 	neutralno
Sam portret Judite učinio mi se veoma zanimljiv od samoga početka. 	pozitivno 
Gavran stvara novu Juditu, a čini mi se da je njegova Juditi povijesno i kulturološki gledano poprilično uvjerljiva. 	neutralno
Ne bi dalje komentirala radnju i druge likove, ali reći ću da Judita za mene postaje lik u pravom smislu riječi tek kada upoznaje vojskovođu čiju glavu treba odrubiti. 	neutralno
U tom susretu ona ostvaruje svoju pravu dubinu. 	neutralno
Obrat koji je tu Gavran postigao nešto je izvanredno, ali ne želim ga pobliže opisivati jer bi to bilo potpuno otkrivanje samoga zapleta. 	pozitivno
Sam jezik je prilagođen svome originalnom uzorku. 	neutralno
Gavran koristi imperfekt i aorist veoma često, uspješno prizivajući osjećaj biblijskoga (starozavjetnoga) pripovijedanja. 	neutralno 
Juditine misli, pa i način govora, sve u sebi ima nešto starozavjetno, priziva sliku jednoga semitskoga društva oštrih stavova i pravila. 	neutralno
Pisanje je veoma ujednačeno, Judita je uvjerljiv pripovjedač u svakome trenutku. 	neutralno
Konačno, ovaj roman se otkriva kao zaokruženo djelo, s izvrsnim zapletom i dubokim krajem, a posebno se odlukuje nadasve istančanom psihološkom karakterizacijom glavnoga ženskoga lika. 	pozitivno
Dubina i bol ove priče duboko su me dojmile, do te mjere da bi ovaj roman nazvala jednim od najboljih koje sam imala priliku čitati. 	pozitivno
Kroz svoj čitateljski staž pročitala sam velik dio opusa g. Gavrana, što drame, romane a i ponešto za mlade. 	neutralno
Juditom sam završila njegovu biblijsku trilogiju (Judita, Krstitelj, Pilat) i mogu reći da me Judita izula iz cipela. 	pozitivno
Svaka čast Marulićevoj Juditi, ali Gavranova je puno više žena od krvi i mesa. 	pozitivno
A g. Gavranu naklon do poda. 	pozitivno
Nema riječi kojim nisam nahvalila njegova djela, a on me svaki put iznova oduševi. 	pozitivno
Tak da više doslovno nemam riječi. 	pozitivno
Fantastično nešto. 	pozitivno
Drugo čitanje 25.5.2023. 	neutralno 
Judita je definitivno knjiga koja se čita više puta, zato mi je baš drago da imam primjerak za sebe. 	pozitivno 
I ovaj drugi put je nevjerojatno, strašno dobra. 	pozitivno
Žena kakve nema na instagramima i ostalim mrežama. 	neutralno
Pitanje ima li više uopće išta slično na svijetu, kao što je Gavranova Judita. 	pozitivno
Film potencijalno famozan, u pravim rukama. 	pozitivno
Možda ga netko poželi napraviti. 	neutralno
Gavranova priča o Juditi, iako inspirisana Marulićem i biblijskom pričom o Juditi, krajnje je originalna. 	pozitivno
Njegova junakinja nije samo smjerna udovica, već je i žena koja voli i kao svaki čovjek, ona griješi. 	neutralno 
Međutim, za svaki grijeh se pokajala i posljedice je skupo platila. Neutralni
Posle 500 godina, od Marulića neko se usudio ispričati priču o biblijskoj legendi, na novi način. 	neutralno
Likovi u romanu bazirani su na biblijskim ali su daleko kompleksniji. 	neutralno
Roman je napisan jednostavno, a lik Judite oslikan je na način svojstven samo Gavranu. 	neutralno
Njen odnos sa Holofernom predstavljen je kao intiman odnos dvoje mladih ljudi, a ne neprijatelja. 	neutralno 
Međutim, kao žena u ranim vremenima ljudskog roda ona i dalje ispašta za svoja dela, osuđena od strane muškaraca koji su superiorni po položaju ali daleko jadniji i slabiji od nje. 	neutralno
Jako ljuta. 	Negativno
Ne prihvaćam ovo. 	Negativno
Previše sam pročitala enemis to lovers knjiga da bi ovo ovako završilo. 	neutralno
Ovo bi trebala biti lektira, Marulića učiti na satu, Gavrana za lektiru, ujedno s time upoznati učenike s terminima intertekstualnosti i postmodernizma, totalni win. Pozitivni
Ali prije da će i Davidijadu ubaciti u obveznu lektiru i dobiti otprilike ovakav rezultat. 	neutralno
Miro je u 21. stoljeću napisao fanfiction na Marulićevu Juditu. 	neutralno
Pretvorio ovu Juditinu sluškinju u lezbu dok su Holoferno i Judita pullali enemies to lovers trope. 	neutralno 
Ovaj roman Judita sama piše. 	neutralno
Piše o slavljenoj pobjedi nad neprijateljem iz svoje perspektive. 	neutralno 
Piše o braku s Manašeom. 	neutralno
O ljubavi koju je spoznala tek kad je upoznala svog neprijatelja. 	neutralno
To je pristojno umjetničko djelo. 	pozitivno
Mogao bih je čitati iznova i iznova i svaki put mi je zanimljivo kao da sam je prvi put čitao. 	pozitivno
Stvarno sam uživao u ovoj priči. 	pozitivno
Imala sam jako niska očekivanja s obzirom da je lektira, no jako mi se svidjelo i nisam očekivala takav ishod. 	pozitivno
Odlučio sam pročitati Juditu Mire Gavrana prije epske pjesme koju je napisao "otac hrvatske književnosti", Judite. 	neutralno
Ova verzija Mire Garvrana prepričava originalnu Juditu i zadivljen sam - ne mogu vjerovati da sam skoro zaboravio radost kada čitate knjigu Mire Gavrana - njegova jednostavnost i lijepo pisanje tjera me da poželim da mogu tako pisati. 	pozitivno
Još se sjećam kako sam se tresla prije nekoliko godina kad sam ga srela na Interliberu (najvećem hrvatskom sajmu knjiga). 	pozitivno
Bio je jako fin i slikali smo se, a ja sam čak dobila i autogram. 	pozitivno
Bilo je tako dobro. 	pozitivno
Pet godina nakon što ubih Holoferna odlučih povjeriti svoju priču šutljivom papiru i čovjeku koji će je naći nakon moje smrti , da bar on sazna istinu da ne spasih ja Betuliju i Izrael od Asiraca , nego da im spas donese ljubav čovjeka kojem bijaše draža smrt negoli život bez žene koju ljubljaše svim srcem. 	neutralno 
Odlična! 	pozitivno 
Originalna, formom jednostavna reinterpretacija biblijskog interteksta, a slažem se s piscem pogovora da je najteže biti jednostavan. 	pozitivno
Drugi Gavranovi romani dolaze mi na To read list. 	pozitivno
Jednostavno, ali sjajno. 	pozitivno
Odličan roman u svakom pogledu, tko se ne slaže neka šuti. 	pozitivno 
Sviđa mi se jednostavnost djela, novi prikaz mitološke priče, zanimljiv obrat. 	pozitivno
Pročitaš je u dahu. 	pozitivno
Ne mogu uskratiti pohvalu Miru Gavranu kad kažem da je njegov stil pisanja izuzetan. 	pozitivno 
Uživala sam čitajući ga, ali moj užitak je bio uskraćen same radnje dijela. 	pozitivno 
Koliko god shvaćam genijalnost njegove karakteristike likova, njihovih odluka toliko ih i mrzim. 	neutralno 
Mrzim što je Judita takva vjernica da dopušta ono što ne bi smjela. 	Negativno
Dopušta osjećati krivnju nad svojim silovanjem, dopušta lagati sebi i drugima o svome činu, da je ubila Holoferna samo zato što je Joakim tako naredio. 	neutralno
Nakon čitanja zadobila sam još veću mržnju nad ovakvom religijom koji bi više podarile ime kulta nego religije. 	Negativno 
Sada još manje shvaćam ljude koji dobivaju sreću ponašati se ovako. 	neutralno
Ljutim se na Juditu koja prihvaća se samo moliti do kraja života i tako nalaziti mir u potpunoj laži. 	Negativno
Ali, ja se mogu raspravljati o takvim temama danima. 	neutralno
Sada ću samo završiti sa time da ponekad stvarno strahujem nad ljudskom logikom i da ovo djelo ne bi više čitala i samo poštovala radi umijeća zapisa. 	neutralno
Knjiga me ostavila bez riječi. 	pozitivno
Toliko je dobra da to ne mogu opisati, jer i dalje razmišljam o njoj. 	pozitivno
Tematika je teška, ali daje sasvim novi pogled na Juditu i njen život, pogotovo Holoferna. 	neutralno 
Likovima daje više osobnosti nego druge verzije. 	neutralno
Preporučujem svima koji su pročitali originalnu ili Marulićevu Juditu da pročitaju i ovu. 	pozitivno
Ovo me satralo. 	Negativno
Pliz ako imate ovu lektiru čitajte! 	pozitivno
Bog blagoslovio miru gavrana. 	pozitivno
Malo je neukusno i neugodno na nekim dijelovima, i prva polovica knjige je stvarno nezamisliva za ženu današnjeg doba te je omalovažavajuće na neki način, no takva su vremena tada bila. 	Negativno
Druga polovica stvarno knjiga uhvati ritam i svaka stranica me ostavila u uzbuđenju za sljedeću. 	pozitivno
Holofern Judita 4ever. 	pozitivno
Gavran dobro ulazi u ženska razmišljanja. 	pozitivno 
Odlično plakala sam. 	pozitivno
Odlična obrada Marulićeve Judite. 	pozitivno
Usudio bih se reći da je ovo djelo savršeno za usporedno čitanje s Marulićevom verzijom. 	pozitivno
To bi vjerojatno dosta pomoglo učenicima i studentima koji ne mogu probaviti dvostruko rimovane dvanaesterce. 	pozitivno
Nije me baš oduševilo kao što na poleđini knjige piše da me očekuje. 	Negativno
Ali lijepo mi je prikratilo vrijeme. 	pozitivno
Uglavnom solidna fanfikcija temeljena na Bibliji. 	pozitivno
Pretvaranje šesnaestostoljetnog djela hrvatske književnosti. 	neutralno
Pretpostavljam da sam očekivao više, ali bilo je sasvim u redu. 	pozitivno
S obzirom da sam to čitao za školu bilo je u redu, ali tako dosadno i neću lagati malo seksistički. 	Negativno
Doslovno progutana, odlična. 	pozitivno
Miro Gavran je zakon! 	pozitivno
Glupo, previše. 	Negativno
Meh, samo meh. 	Negativno
Odlično. 	pozitivno
Jako dobra knjiga. 	pozitivno
Pa, ne volim baš ovakve knjige, ali morao sam je pročitati za školu. 	Negativno
Pročitao sam je u jednom dahu i bilo je stvarno opuštajuće. 	pozitivno
Solidna knjiga. 	pozitivno
Lektira. 	neutralno
-0 zvjezdica! 	Negativno
Drago mi je što sam novu započela baš s ovim naslovom. 	pozitivno
Gavran mi je samo još jednom potvrdio da s njim nema greške. 	pozitivno
Ljepota cijele priče je u jednostavnosti glavnog lika i svih njegovih shvaćanja svijeta koji ga okružuje. 	pozitivno
Mislav je ona neiskvarena osnova svih nas, te me u tom pogledu podsjetio na Augusta iz knjige Čudo. 	pozitivno
Osjećajno, lagano, zanimljivo, životno, kratko i jasno. 	pozitivno 
S neočekivanim završetkom! 	neutralno
Svaka riječ je suvišna. 	pozitivno
Miro je Miro. 	neutralno
Nije me se toliko dojmila prilikom ponovnog čitanja. 	Negativno
Želio bih da je ova knjiga puno duža da se imam više vremena emocionalno povezati s Mislavom. 	neutralno
Jedna od najboljih knjiga ikada, preporučam svima da pročitaju ovu knjigu barem jednom. 	pozitivno
Život iz perspektive zaboravljenog sina nikoga ne može ostaviti ravnodušnim. 	pozitivno
Knjiga o kojoj se dugo, dugo razmišlja i nakon čitanja. 	pozitivno
G. Gavran opet nije razočarao. 	pozitivno
Preporučam pročitati svakako. 	pozitivno
Ovo mi je prvo štivo koje sam čitala od Gavrana i jako me dojmio. 	pozitivno
Kraj me baš ''zdrmal'' tako da i ovo jutro vrtim priču u mislima. 	Negativno
Riječ je o kratkom romanu, pisanom u prvom licu, u formi dnevničkih bilježaka. 	neutralno
Glavni je lik retardirani mladić koji je ostao na mentalnoj razini dječaka od deset godina. 	neutralno
Nakon što je petnaestak godina proveo u specijalnoj školi u Zagrebu, gdje je završio zanat, on se vraća u obitelj - i tu počinje drama. 	neutralno
Otac osjeća žaljenje što je dopustio da ''sakriju sramotu'', majka i dalje uvjerena da je taj sin njihova ''sramota'' i da je dobro bila odlučila da ga se krije od svih. 	neutralno
Kakva će biti posljedica tih odluka nakon vraćanja u obitelj. 	neutralno
Odličan! 	pozitivno
Jedno od najboljih djela koja sam pročitala. 	pozitivno
Gavran je um glavnog junaka pretočio u niz jednostavnih, čistih misli i toliko dobro oslikao specifičnu atmosferu na selu, zbog kojih postavljam nove kriterije za ostale pisce i djela koja ću tek pročitati. 	pozitivno
Ono sto bi se u današnje Internet doba reklo: "neprocjenjivo". 	pozitivno
Jako mi se svidjela jer je lako štivo za srednje učenike hrvatskog poput mene. 	pozitivno
I bio je to zanimljiv uvid u život hrvatskog sela i kako se mladi čovjek koji je drugačiji bori da se uklopi. 	pozitivno
Međutim, zadnje dvije stranice samo su uništile cijeli doživljaj. 	Negativno
Zašto svaka hrvatska knjiga, film ili predstava mora biti tako jebeno turobna? 	Negativno
Roman je sve u svemu simpatičan i zabavan, ali ga jako umanjuje nekoliko melo dramatičnih trenutaka koji ga prebacuju u teritorij sapunice. 	pozitivno
Ipak, čitak, sladak, mjestimice smiješan, a toliko kratak da ga je šteta ne pročitati. 	pozitivno
Knjiga je odlična, oduševljena sam. 	pozitivno
S obzirom da studiram fakultet vezan za djecu i odrasle s (po)teškoćama u razvoju - ova knjiga me dirnula i toliko mi pomogla da bolje razumijem tu perspektivu. 	pozitivno
Hvala za ovu knjigu, smatram da je svako treba barem jednom u životu pročitati kako bi shvatili svijet iz drugog ugla i kako bismo se svi mi bolje ponašali jedni prema drugima i bili zahvalniji prema svemu oko nas. 	pozitivno
Knjiga napisana iz perspektive Mislava, mladića koji je 15 godina svoga života proveo u domu za djecu s posebnim potrebama, pa ga s njegovih 20 roditelji odluče vratiti u obiteljski dom u Omorini, selu u blizini Nove Gradiške. 	pozitivno
Kroz Mislavove dnevničke zapise spoznajemo na koji način on poima i osjeća stvari i ljude oko sebe. 	neutralno
Osjeća se jedna iskrenost, nevinost, dobrota. 	pozitivno 
Meni jedna od dražih knjiga. 	pozitivno
Knjiga puna života, u svakom smislu. 	pozitivno
Knjiga o ljubavi i obitelji, predrasudama i stigmama, očekivanjima, prijateljstvu i svemu što život sa sobom nosi. 	neutralno 
Priča o Mislavu koji je drugačiji, a opet isti kao svi mi, čovjek koji voli i želi biti voljen, takav kakav je. 	neutralno
Lagani roman pun emocije. 	pozitivno 
Pitak, emotivan, divan. 	pozitivno
Predivna knjiga! 	pozitivno 
Posebno djelo koje nas ostavlja zamišljene. 	pozitivno
Kako doživljavamo one koji su drugačiji od nas, a ipak posebni. 	neutralno
Kako je društvo puno predrasuda. 	neutralno
Zaplet je gotovo deus ex machina. 	neutralno
Sve u svemu, ostatak je značajan- baca svjetlo na život iz nesvakidašnjeg kuta. 	neutralno
Koliko god volim Gavrana i njegove priče, u ovu me nije uspio uvući. 	Negativno
Monotono je riječ kojom bih opisala pročitano, a to nikako nije dobro. 	Negativno
Emocije nisu bile probuđene, likovi su mi bili dvodimenzionalni, cijela priča nekako kao „odrađena“. 	Negativno
No, ja se i dalje veselim idućem sastanku s piscem! 	pozitivno
Jako mi se svidio.. i to ispreplitanje povijest/sadašnjost. 	pozitivno
Ovu povijest iz Hercegovine u Slavoniju sa vlakovima puni djece nisam čula a ni znala. 	neutralno
Budem si kasnije malo istražila tu stranu fra Didaka Buntića. 	neutralno
Hrabar čovjek. 	pozitivno